{
  "MaxTurn" : 35,
  "AvaiableTiles" : [1, 2, 3],
  "Data": [
    [1, 1, 1, 1, 1, 1, 1, 1, 1],
    [99, 0, 0, 0, 0, 0, 0, 0, 99],
    [99, 0, 0, 0, 0, 0, 0, 0, 99],
    [99, 0, 0, 6, 0, 6, 0, 0, 99],
    [6, 0, 6, 6, 6, 6, 6, 0, 6],
    [0, 7, 0, 7, 0, 7, 0, 7, 0],
    [0, 7, 6, 6, 8, 6, 6, 7, 0],
    [6, 0, 6, 0, 0, 0, 6, 0, 6]
  ],
  "Tiles": [
    [0, 0, 0, 0, 0, 0, 0, 0, 0],
    [0, 1, 2, 1, 3, 1, 2, 1, 0],
    [0, 2, 3, 3, 2, 3, 3, 2, 0],
    [0, 2, 2, 3, 2, 3, 2, 2, 0],
    [3, 3, 2, 2, 1, 2, 2, 3, 3],
    [2, 1, 2, 1, 2, 1, 2, 1, 2],
    [2, 1, 3, 2, 1, 2, 3, 1, 2],
    [3, 2, 3, 2, 1, 2, 3, 2, 3]
  ],
  // "Quests": [
  //     {
  //       "QuestID": 103,
  //       "Quantity": 24
  //     }
  // ]

  "Quests": 
  [
      [103,24]
  ]
}